0,0,0,0,0,0,0,0,0,0,0,0,0,0
0,0,0,0,1121,1122,0,0,0,0,0,0,0,0
0,1521,1523,1173,1129,1130,0,0,0,0,0,0,0,0
0,1280,1555,1181,1137,1138,0,0,0,887,888,0,0,0
0,0,0,0,0,0,0,1329,0,895,896,0,0,0
0,1201,1202,1203,0,0,1340,1337,0,0,0,0,0,0
0,1209,1210,1211,0,0,1348,1345,0,0,0,0,0,0
0,1217,1218,1219,0,0,0,0,0,0,0,0,0,0
0,0,0,0,0,0,0,0,0,0,0,0,0,0
0,0,0,0,0,0,0,0,0,0,0,0,0,0
0,0,0,0,0,0,0,0,0,0,0,0,0,0
