0,0,0,0,0,0,0,0,0,0,0,0,0,0
0,0,0,1147,1148,0,1329,0,0,0,0,0,0,0
0,1186,1187,1155,1156,0,1337,0,0,0,0,873,874,0
0,1194,1195,1163,1164,0,1345,0,0,0,0,881,882,0
0,0,0,0,0,0,0,0,0,0,0,889,890,0
0,0,0,0,0,1291,1700,1702,1292,0,0,0,0,0
0,1382,0,0,0,1291,1708,1710,1292,0,0,0,1382,0
0,1390,0,0,0,0,0,0,0,0,0,0,1390,0
0,1398,0,0,0,0,0,0,0,0,0,0,1398,0
0,0,0,0,0,0,0,0,0,0,0,0,0,0
0,0,0,0,0,0,0,0,0,0,0,0,0,0
