0,0,0,0,0,0,0,0,0,0,0,0,0,0
0,0,0,0,0,0,0,0,0,0,0,0,0,0
0,0,0,0,0,0,0,0,0,0,0,0,0,0
0,386,386,386,386,386,386,386,386,386,386,377,377,0
0,386,377,377,377,377,377,377,377,377,377,386,386,0
0,386,377,377,377,377,377,377,377,377,377,377,377,0
0,386,377,377,377,377,377,377,377,377,377,377,377,0
0,386,377,377,377,377,377,377,377,377,377,377,377,0
0,386,377,377,377,377,377,377,377,377,377,377,377,0
0,386,377,377,377,377,377,377,377,377,377,377,377,0
0,0,0,0,0,0,0,0,0,0,0,0,0,0
