159,159,159,159,159,159,159,159,159,159,159,159,159,159
159,33,33,33,33,33,33,33,33,33,33,33,33,159
159,41,41,41,41,41,41,41,41,41,41,41,41,159
159,0,0,0,0,0,0,0,0,0,0,0,0,159
159,0,0,0,0,0,0,0,0,0,0,0,0,159
159,0,0,0,0,0,0,0,0,0,0,0,0,159
159,0,0,0,0,0,0,0,0,0,0,0,0,159
159,0,0,0,0,0,0,0,0,0,0,0,0,159
159,0,0,0,0,0,0,0,0,0,0,0,0,159
159,0,0,0,0,0,0,0,0,0,0,0,0,159
159,159,159,159,159,159,159,159,159,159,159,159,159,159
