0,0,0,0,0,0,0,0,0,0,0,0,0,0
0,0,0,0,0,0,0,0,0,0,0,0,1074,0
0,0,0,0,0,0,0,0,0,0,0,0,1082,0
0,1553,0,0,0,0,0,0,0,0,0,904,0,0
0,0,0,0,0,0,0,0,0,0,0,912,0,0
0,0,0,0,0,785,786,786,786,787,0,0,0,0
0,0,0,0,0,793,794,794,794,795,0,0,0,0
0,0,0,0,0,793,794,794,794,795,0,0,0,0
0,0,0,0,0,801,802,802,802,803,0,0,0,0
0,0,0,0,0,0,0,0,0,0,0,0,0,0
0,0,0,0,0,0,0,0,0,0,0,0,0,0
