0,0,0,0,0,0,0,0,0,0,0,0,0,0
0,0,0,0,0,0,0,1108,1109,0,0,0,0,0
0,0,0,0,0,0,0,1116,1117,0,0,0,0,0
0,0,0,0,0,0,0,0,0,0,904,0,0,0
0,0,0,0,785,786,786,786,786,787,912,0,0,0
0,0,0,0,793,794,794,794,794,795,0,0,0,0
0,0,0,0,793,794,794,794,794,795,0,0,0,0
0,0,0,0,801,802,802,802,802,803,0,0,0,0
0,0,0,0,0,0,0,0,0,0,0,0,0,0
0,0,0,862,863,864,0,0,0,0,0,0,0,0
0,0,0,870,871,872,0,0,0,0,0,0,0,0
